Арахнофобия - боязнь пауков 
Хлуофобия — боязнь темноты
Зоофобия — боязнь животных
Генофобия — это страх перед сексом и сексуальными отношениями
Гемофобия - страх перед видом крови
Клаустрофобия - Боязнь закрытых пространств
Акрофобия - боязнь высоты
Аутофобия - боязнь одиночества
Гермофобия - страх загрязнения и попадания микробов на тело
Дентофобия - боязнь стоматологов
Агорафобия - боязнь открытых пространств
Коулрофобия - боязнь клоунов
нет
нет
нет
нет
нет
нет
нет
нет
нет
нет
нет
нет
нет
нет
нет
Офидиофобия — боязнь змей
Андрофобия — боязнь мужчин
Гравидофобия - боязнь женщин
трихофобия - боязнь волос
Педофобия — боязнь детей
Гелиофобия — боязнь солнца
Дидаскалейнофобия — боязнь школы
Филофобия — боязнь влюбиться
Антропофобия - боязнь детей
Глоссофобия — боязнь выступлений на публике
Аквафобия — боязнь воды
Аэрофобия - боязнь летать на самолётах
Хрометофобия — боязнь денег
Фонофобия - боязнь громких звуков
Кинофобия - боязнь собак
Айлурофобия - боязнь котов
Орнитофобия - боязнь птиц
Боится полицейских
Земмифобия - боязнь крыс и других грызунов
Сцифофобия - боязнь медуз
